111111111111111
120000000000000
111111111111100
100000000000100
101111100000100
101000100000100
101000100000100
101000100000100
101000100000100
101000111111100
101000000000000
101000000000000
101000111111111
100000000000003
111111111111111
