111111111111111
100000000000001
100111101010011
100000101010031
111111101111111
120000000001001
111111101111001
101010100000001
101010100000011
101010100010001
101010100010001
100000100011111
100111100000101
100000000000001
111111111111111
