111111100000000
000200100000000
000000100000000
000000100000000
000000100000000
000000100000000
000300100000000
000000000000000
000000000000000
000000000000000
000000000000000
000000000000000
000000000000000
000000000000000
000000000000000
