111111111111111
100000000000001
120000000000001
111111000000001
100000000000001
100000000000001
100000001111111
100000000000001
111111000000001
100000000000001
100000000000001
100000011111111
100000000000001
100000000000031
111111111111111
